+ ------------+
|             |
|----+ +----+ |
|    |      | |
| +--+ +--+ +-|
| |    |      |
| +-------+ +-|
|   |     | | |
| +-+ +---+ + |
| |           |
| + +---------|
|   |         |
| + + +---+ +g|
| |   |     |e|
+------------a+